** R  1920 1080
R 1280 720
** R 600 x 400
no ./textures/blueMetal.xpm
SO ./textures/yellowMetal.xpm
WE ./textures/greenMetal.xpm
EA ./textures/pinkMetal.xpm
S 2./sprites/normiSprite.xpm 2./sprites/normiDamaged.xpm 3./sprites/marvin.xpm 4./sprites/potionanimation/redpotion.xpm 4./sprites/potionanimation/redpotion1.xpm 4./sprites/potionanimation/redpotion2.xpm 4./sprites/potionanimation/redpotion3.xpm 4./sprites/potionanimation/redpotion4.xpm 4./sprites/potionanimation/redpotion5.xpm 4./sprites/potionanimation/redpotion6.xpm 5./sprites/spray.xpm 6./sprites/oren.xpm 7./sprites/gemanimation/1.xpm 7./sprites/gemanimation/2.xpm 7./sprites/gemanimation/3.xpm 7./sprites/gemanimation/4.xpm 7./sprites/gemanimation/5.xpm 7./sprites/gemanimation/6.xpm 7./sprites/gemanimation/7.xpm 7./sprites/gemanimation/8.xpm
F ./bonustextures/newBricks.xpm
c ./bonustextures/sandbrick.xpm

basurilla
l33t hacker

** Mapa Válido **

111111111111111111111111
100000016110000000000001
1100001050v0000000040001
100000010110000000000001
1111111101111111111v1111
10000111/110000000000001
100000007000000000000001
100000000000000000000011
100000000000000000000111    1111111111111111
10000000n000000000001111    1000000000000001
100010000000000000011111111110001000001000001
10000000000000000000000v0000/000000000000000/1
100000000000000000011111111110001000001000001
100000000000000000001111    1000000000000001                    1
10000000000000000000v411    1111111111111111                   101
100000000000000000001111                                      10201
111111111000000000000001    111  1                           1010101
113110001000000000000001    1*1 1*1                         100000001
1000v040v000000000000001    101  1                           1010101
100010001000000001010001    111                               10001
100011111/10000001010001    111111111111111111111111111111111111011
100011100011111001001111    1*000000000000000000000000000000000/01
10400/001100070001000071    11111111111111111111111111111111111111
111111111111111111111111    
