** INSTRUCTIONS
** R    screenWidth screenHeight
** NO   relative path to .XPM texture for north wall
** SO   relative path to .XPM texture for south wall
** WE   relative path to .XPM texture for west wall
** EA   relative path to .XPM texture for east wall
** S    relative path to .XPM texture for sprite
** F    R,G,B color value for floor
** C    R,G,B color value for ceiling
** MAP ARRAY

R  1920 1080
R 394 3949
no ./textures/blueMetal.xpm
SO ./textures/yellowMetal.xpm
WE ./textures/greenMetal.xpm
EA ./textures/pinkMetal.xpm
S ./sprites/normiSprite.xpm
F 102,153,153
C 102,0,255

basurilla
l33t hacker

** Mapa Válido **

111111111111111111111111
101
101111111111111111111111
100000000000000000000001
100000111110000101010001
100000100010000000000001
10000010s010000100010001
100000102010000000000001
100000110110000101010001
100000000000000000000001
100000000000000000000001
100000000000000000000001
100000000000000000000001
100000000000000000000001
100000000000000000000001
100000000000000000000001
111111111000000000000001
110100001000000000000001
110000101000000000000001
110100001000000000000001
110111111000000000000001
110000000000000000000001
100000000000000000000001
111111111111111111111111
101
101111111111111111111111
