** INSTRUCTIONS
** R    screenWidth screenHeight
** NO   absolute or relative path to .XPM texture for north wall
** SO   absolute or relative path to .XPM texture for south wall
** WE   absolute or relative path to .XPM texture for west wall
** EA   absolute or relative path to .XPM texture for east wall
** S    absolute or relative path to .XPM texture for sprite
** F    R,G,B color value for floor
** C    R,G,B color value for ceiling
** MAP ARRAY

** No saltan bien errores de 'incorrect specifier', limpiar buscadores
** getCColor es tolerante a falta de especificador pero tira un error, (o_O) Comportamiento deseado: intolerante.
** getFColor no es tolerante ni tira el error. (o_O) Comportamiento deseado: que tire el error.
** Hay que encontrar la diferencia. R es intolerante y tira bien el error, lo cual es correcto. ;)

R  1920 1080
no ./blueMetal.XPM
SO ./yellowMetal.XPM
WE ./greenMetal.XPM
EA ./pinkMetal.XPM
S ./normiSprite.XPM
F 	102 , 153,153
C	102,0,255

basurilla
l33t hacker

** Mapa Válido **

111111111111111111111111
101
101111111111111111111111
100000000000000000000001
100000111110000101010001
100000102010000000000001
10000010s010000100010001
100000102010000000000001
100000110110000101010001
100000000000000000000001
100000222200000000000001
100000020000000000000001
100000002000000000000001
100000000000000000000001
100000000000000000000001
100000000000000000000001
111111111000000000000001
110100001000000000000001
110000101000000000000001
110100001000000000000001
110111111000000000000001
110000000000000000000001
100000000000000000000001
111111111111111111111111

** Mapa Válido **

        1111111111111111111111111
        1000000000110000000000001      111
        1011000001110000002000001      101
        1001000000000000000000001      101
111111111011000001110000000000001      111
100000000011000001110111111111111
11110111111111011100000010001
11110111111111011101010010001
11000000110101011100000010001
10002000000000001100000010001               11111
100000000N0000001101010010001               10201
11000001110101011111011110001               11111
11110111 1110101 101111010001
11111111 1111111 111111111111

** Mapa Válido - Mapa sin Sprites y sin SpriteTex **

111
1S1
111

** Mapa Inválido 6 **

111111111111111111111111
100000000000200000000001
100000000000002000000001
100000000000020000000001
100000111110000101010001
100000100100000000000001
100000100010000100010001
100000100010000000000001
100000110110000101010001
100000000000000000000001
100000000000000000000001
100000000000000002000001
100000000000000000000001
100000000000000000000001
100000000000000000000001
100000000000000000000001
111111111000000000000001
110100001000000000000001
110000101000000000000001
110100001000000000000001
110111111000000000000001
110000000000000000000001
100000000000000000000001
1111111111111111111N1111

** Mapa Invalido 5 **

111
1s1
1n1
111

** Mapa Invalido 4 **

1111
1ses1
1011
111

** Mapa Invalido 3 **

111
1s1
101
1!1

** Mapa Invalido 2 **

111
1s1


** Mapa Invalido 1 **

111
101
1s1