** INSTRUCTIONS
** R    screenWidth screenHeight
** SO   FAKE PATH
** NO   absolute or relative path to .XPM texture for north wall
** SO   absolute or relative path to .XPM texture for south wall
** WE   absolute or relative path to .XPM texture for west wall
** EA   absolute or relative path to .XPM texture for east wall
** S    absolute or relative path to .XPM texture for sprite
** F    R,G,B color value for floor
** C    R,G,B color value for ceiling
** MAP ARRAY

R   800 800
no  ./blueMetal.XPM
SO  ./yellowMetal.XP
WE  ./greenMetal.XPM
EA  ./pinkMetal.XPM
S   ./normiSprite.XPM
F   102,153,153
C   102,0,75

basurilla
l33t hacker
111111111111111111111111
100000000000200000000001
100000000000002000000001
100000000000020000000001
100000111110000101010001
10000010S010000000000001
100000100010000100010001
100000100010000000000001
100000110110000101010001
100000000000000000000001
100000000000000000000001
100000000000000002000001
100000000000000000000001
100000000000000000000001
100000000000000000000001
100000000000000000000001
111111111000000000000001
110100001000000000000001
110000101000000000000001
110100001000000000000001
110111111000000000000001
110000000000000000000001
111111111000000000000001
111111111111111111111111
er mapa a cava haki tronko

